[buffer] = 24
111111111111111111111111
1......................1
1.......111.........1..1
1..........1111..1111..1
1....11.......1...111..1
1....11111....1....11..1
1...11........1.....1..1
1.............1........1
1.....111111.......11111
1.....1..........1.....1
1.....1111....1111.....1
1.............1........1
1......................1
111111111111111111111111


